jobId,executionId,jobName,startedTick,finishedTick,ticks,startedAt,finishedAt,startLateBy,resourceUsage
8928ee14-b930-4f12-b56e-e6f414d97208,30db1a27-bfea-49d5-9019-24dec2ab33af,Job 05,7,16,9,2024-04-29T07:11:18.039Z,2024-04-29T07:11:36.003Z,0,5
0daa9025-733d-43cc-b086-6b5325639253,cf6074e8-f5db-4f90-9618-9c3670df93f6,Job 08,7,19,12,2024-04-29T07:11:18.042Z,2024-04-29T07:11:42.004Z,0,10
6c5972cc-f0e4-4c9c-b3d3-5c67b578d22a,7cbcfc40-ed93-4623-8a05-4b6686700c2c,Job 11,7,19,12,2024-04-29T07:11:18.045Z,2024-04-29T07:11:42.009Z,0,5
ad8e7d34-1761-46f8-a58e-0ff2d139af54,c85b2c15-ede8-4d53-8515-dde85b3cea3b,Job 03,7,22,15,2024-04-29T07:11:18.036Z,2024-04-29T07:11:48.001Z,0,3
b9ae2d9b-57f6-454e-9b0c-b7f876517253,0c921048-f1d9-449a-a37c-9bee4dff1324,Job 01,19,27,8,2024-04-29T07:11:43.018Z,2024-04-29T07:11:58.003Z,0,3
88b1f739-e5c2-4c28-97a1-6c0480bd898a,b0e57476-071d-439e-891f-9576a1fb432b,Job 02,19,27,8,2024-04-29T07:11:43.021Z,2024-04-29T07:11:58.009Z,0,3
7c38a66d-c698-4d6d-b4ef-8ef211bba47f,c25e6e38-3e51-4521-bc8f-1244bc9b02e3,Job 06,19,27,8,2024-04-29T07:11:43.026Z,2024-04-29T07:11:58.012Z,0,5
58725ef0-4092-4771-840c-57fe993cf3e0,de688a90-561e-4bdd-b0ab-33bdc6700808,Job 07,19,27,8,2024-04-29T07:11:43.029Z,2024-04-29T07:11:58.015Z,0,10
a5c32af3-6dcc-4ae8-87da-43aed5f35b68,aba5e3ca-d0cd-438a-8bb2-8f2a820a4b44,Job 09,19,27,8,2024-04-29T07:11:43.032Z,2024-04-29T07:11:58.018Z,0,10
7ae15ec7-037b-4210-a39a-a676eb8d38d9,8bb2024d-b428-4c58-8347-babc6658f810,Job 14,19,27,8,2024-04-29T07:11:43.040Z,2024-04-29T07:11:58.022Z,0,5
2d1801e9-c08f-4eda-b6ff-c14331d9b377,bf2ce11f-45a1-4525-b4b7-ff8e00a3b1ff,Job 04,19,28,9,2024-04-29T07:11:43.023Z,2024-04-29T07:12:00.004Z,0,5
fe7083ab-f285-40c7-9add-616af680bec0,3b7b06c0-d4ba-44fa-922a-e0cde1195269,Job 13,19,33,14,2024-04-29T07:11:43.038Z,2024-04-29T07:12:10.002Z,0,5
095c0e3d-4228-4c9c-b8fd-ef1d4a33f02b,b5c68d45-279e-4bca-ba93-e7f516e36b33,Job 10,19,34,15,2024-04-29T07:11:43.035Z,2024-04-29T07:12:12.003Z,0,3
edd4f952-9210-47e1-acf7-dbbbb84bb57d,c3773039-1130-4310-91f3-8df94e44e70e,Job 15,19,34,15,2024-04-29T07:11:43.043Z,2024-04-29T07:12:12.008Z,0,5
a7a731da-09d6-4b72-b760-f8d03acfef1a,71898bd8-5ed2-4fcb-8952-5b0dca6be1e9,Job 16,29,37,8,2024-04-29T07:12:03.036Z,2024-04-29T07:12:18.002Z,0,3
6703f5fe-0e4c-4e4a-b66b-9c75fdd0aaac,36f9af71-ee06-400b-951c-0fb37b7dd552,Job 17,29,37,8,2024-04-29T07:12:03.050Z,2024-04-29T07:12:18.012Z,0,5
ce118bed-b567-470d-8c5c-9afc6830396a,2d851770-84da-41a1-b004-f5a521199aa6,Job 18,29,37,8,2024-04-29T07:12:03.054Z,2024-04-29T07:12:18.023Z,0,5
1466c45c-35bb-4b88-b629-87563673226f,0ded22cd-e9ae-47b7-91fa-f44ebb8df1da,Job 19,29,37,8,2024-04-29T07:12:03.067Z,2024-04-29T07:12:18.030Z,0,5
824adc77-0631-4d1e-9e59-a07337c77ebc,3d7be2f2-2a87-4783-b866-f5690541d805,Job 20,34,42,8,2024-04-29T07:12:12.025Z,2024-04-29T07:12:28.002Z,0,10
a2f44b61-dd4c-4b45-b440-83a2748b27b2,5a4e269b-c70d-4458-b46e-06026c92d4c6,Job 12,37,45,8,2024-04-29T07:12:19.016Z,2024-04-29T07:12:34.004Z,0,10
ad8e7d34-1761-46f8-a58e-0ff2d139af54,9d7ccfca-8c08-4e48-bf16-ad98e3bf55e4,Job 03,148,156,8,2024-04-29T07:16:01.009Z,2024-04-29T07:16:16.001Z,0,3
8928ee14-b930-4f12-b56e-e6f414d97208,bf940f77-ee9c-441c-8917-10bd108daa7b,Job 05,148,156,8,2024-04-29T07:16:01.013Z,2024-04-29T07:16:16.007Z,0,5
0daa9025-733d-43cc-b086-6b5325639253,dbb3e811-36ca-47dd-8ca9-a02f219ceb2b,Job 08,148,156,8,2024-04-29T07:16:01.016Z,2024-04-29T07:16:16.011Z,0,10
6c5972cc-f0e4-4c9c-b3d3-5c67b578d22a,b4ba4535-c843-4b5a-9a0c-2800d9445cd9,Job 11,148,157,9,2024-04-29T07:16:01.019Z,2024-04-29T07:16:18.003Z,0,5
b9ae2d9b-57f6-454e-9b0c-b7f876517253,818bd30d-a543-4245-9e8e-17b34bbaeb3f,Job 01,163,171,8,2024-04-29T07:16:31.029Z,2024-04-29T07:16:46.003Z,0,3
58725ef0-4092-4771-840c-57fe993cf3e0,3c070ee2-0d22-4545-8fa7-ffc6dc91fd37,Job 07,163,171,8,2024-04-29T07:16:31.042Z,2024-04-29T07:16:46.012Z,0,10
a5c32af3-6dcc-4ae8-87da-43aed5f35b68,43387dbc-5a72-4cd1-b5fd-765a0f69ae74,Job 09,163,171,8,2024-04-29T07:16:31.044Z,2024-04-29T07:16:46.021Z,0,10
a7a731da-09d6-4b72-b760-f8d03acfef1a,7e5d2895-12cc-4a0c-af5d-9d80ede220e7,Job 16,163,171,8,2024-04-29T07:16:31.049Z,2024-04-29T07:16:46.031Z,0,3
88b1f739-e5c2-4c28-97a1-6c0480bd898a,dc5d6545-9901-4529-9282-02a71d075f1d,Job 02,163,172,9,2024-04-29T07:16:31.033Z,2024-04-29T07:16:48.001Z,0,3
7c38a66d-c698-4d6d-b4ef-8ef211bba47f,03c41435-0775-40dd-8c1a-e64fe6004b2b,Job 06,163,172,9,2024-04-29T07:16:31.039Z,2024-04-29T07:16:48.003Z,0,5
095c0e3d-4228-4c9c-b8fd-ef1d4a33f02b,d41c0c01-ba6b-4dd1-be03-12e0e38d8d1c,Job 10,163,172,9,2024-04-29T07:16:31.046Z,2024-04-29T07:16:48.004Z,0,3
a2f44b61-dd4c-4b45-b440-83a2748b27b2,cc885a5f-a3ad-4f8d-a5bd-451c938f9f83,Job 12,158,173,15,2024-04-29T07:16:21.030Z,2024-04-29T07:16:50.002Z,0,10
2d1801e9-c08f-4eda-b6ff-c14331d9b377,2df04fec-e11b-4d72-85e7-5e069f24f48a,Job 04,163,177,14,2024-04-29T07:16:31.035Z,2024-04-29T07:16:58.002Z,0,5
fe7083ab-f285-40c7-9add-616af680bec0,f54c0b87-def5-4024-9e6f-321865910458,Job 13,173,181,8,2024-04-29T07:16:51.030Z,2024-04-29T07:17:06.002Z,0,5
7ae15ec7-037b-4210-a39a-a676eb8d38d9,f158f05d-be4c-4c5f-8351-bc631f6ba7c6,Job 14,173,181,8,2024-04-29T07:16:51.036Z,2024-04-29T07:17:06.009Z,0,5
6703f5fe-0e4c-4e4a-b66b-9c75fdd0aaac,c8e7f336-4723-4f52-a4d3-cda3dc59a29d,Job 17,173,184,11,2024-04-29T07:16:51.049Z,2024-04-29T07:17:12.002Z,0,5
1466c45c-35bb-4b88-b629-87563673226f,b6d5ee84-0970-4948-a627-609ec0b3b086,Job 19,173,186,13,2024-04-29T07:16:51.061Z,2024-04-29T07:17:16.002Z,0,5
edd4f952-9210-47e1-acf7-dbbbb84bb57d,cf3e267b-281a-480b-9845-22d96b09807d,Job 15,173,188,15,2024-04-29T07:16:51.043Z,2024-04-29T07:17:20.002Z,0,5
ce118bed-b567-470d-8c5c-9afc6830396a,8bcb6caa-11df-491f-9c3d-5bcbb3f73f3e,Job 18,173,188,15,2024-04-29T07:16:51.055Z,2024-04-29T07:17:20.010Z,0,5
824adc77-0631-4d1e-9e59-a07337c77ebc,4b444013-3d4e-45b8-a565-eb9ee591123d,Job 20,181,189,8,2024-04-29T07:17:06.037Z,2024-04-29T07:17:22.002Z,0,10
