jobId,executionId,jobName,startedTick,finishedTick,ticks,startedAt,finishedAt,startLateBy,resourceUsage
dcd7db79-717a-4599-a09c-df1ab4c1b832,da50ef9e-c3de-4899-97e5-5d99431ca824,Job 01,91,106,15,2024-06-23T12:16:00.018Z,2024-06-23T12:16:30.004Z,0,3
fe1d4aa9-d811-42fb-9fa6-3bf789f48eb2,5d6501bd-4a80-4ce2-94d8-afd250309b10,Job 03,93,108,15,2024-06-23T12:16:04.013Z,2024-06-23T12:16:34.001Z,0,3
1b44d91d-f539-4f87-827b-7298a5446478,c742eee4-4c81-4c7b-860a-0c55e475fc35,Job 04,94,109,15,2024-06-23T12:16:06.008Z,2024-06-23T12:16:36.002Z,0,5
1c7e5d82-38e7-44d9-9111-60dcf3db5427,cda39b9b-d976-459a-9349-e59125177d55,Job 05,95,110,15,2024-06-23T12:16:08.014Z,2024-06-23T12:16:38.003Z,0,5
b1438c9e-a55d-4b6e-ba9b-8ed6314c9253,d283eb10-e6fe-4a4a-9d14-22c6f32ad617,Job 06,96,111,15,2024-06-23T12:16:10.012Z,2024-06-23T12:16:40.003Z,0,5
f6daa432-9dbd-4379-bf10-1954091cb2d8,cefeb786-977a-4173-ae78-493b6b0b5248,Job 02,92,112,20,2024-06-23T12:16:02.018Z,2024-06-23T12:16:42.003Z,0,3
4d3de169-5d7f-4736-bc28-7d75350ba944,aacfcd70-6f39-4d36-8c3d-358d5d56eda1,Job 07,97,112,15,2024-06-23T12:16:12.035Z,2024-06-23T12:16:42.018Z,0,10
da634e83-ccb4-4952-ae5a-e4bf699de161,40ee4d03-795f-45c2-9d7b-8e967a110ed0,Job 08,103,118,15,2024-06-23T12:16:24.027Z,2024-06-23T12:16:54.003Z,0,10
64990f57-3624-4250-9d77-e44553c87137,fe1f2f45-ffeb-4742-9e61-d8f674f0ee62,Job 09,108,123,15,2024-06-23T12:16:34.012Z,2024-06-23T12:17:04.002Z,0,10
38af7bbc-83ba-4d69-b6ab-d1e4ab616049,0a65cfd0-9e52-4269-b4aa-2e0c383b8c76,Job 10,111,126,15,2024-06-23T12:16:40.038Z,2024-06-23T12:17:10.002Z,0,3
22117a9e-4620-4d43-8b35-ce3739653b1e,a62ad735-21a7-4614-a48d-36d3bba23f32,Job 11,112,128,16,2024-06-23T12:16:42.029Z,2024-06-23T12:17:14.003Z,0,5
373c1d7d-f056-4517-b2aa-e0fc9acb4b88,d8c69f69-af53-4a46-bed5-5546b317994f,Job 12,113,129,16,2024-06-23T12:16:44.013Z,2024-06-23T12:17:16.001Z,0,10
300f3b5f-1bda-4a21-9c7b-58513e10d531,7896f995-5ee4-44b3-b9f2-65fe9aa9a734,Job 13,118,133,15,2024-06-23T12:16:54.029Z,2024-06-23T12:17:24.003Z,0,5
6ac1a01d-63f1-424c-8370-67a1861e5ef3,4de19d43-0cda-48a1-abdb-44bc245ffa64,Job 14,123,138,15,2024-06-23T12:17:04.034Z,2024-06-23T12:17:34.002Z,0,5
09acd707-e18d-41e2-8393-73a8eb490d40,a81ef6f0-bbc0-4ce4-a98b-8123595a4c78,Job 16,128,143,15,2024-06-23T12:17:14.014Z,2024-06-23T12:17:44.003Z,0,3
3e9bdbe7-316b-49e7-82d9-64465aec4dd1,628eda16-6785-423f-ad5c-50510a3db1a0,Job 15,124,144,20,2024-06-23T12:17:06.009Z,2024-06-23T12:17:46.001Z,0,5
ec012c8b-5288-4d95-bf92-ce753fe6aaa0,bbbca293-ceaa-415d-9906-804d83ae62d2,Job 17,129,144,15,2024-06-23T12:17:16.012Z,2024-06-23T12:17:46.003Z,0,5
6fcaea72-db8b-4e01-884c-4600ef174830,895ec543-840a-4a60-9639-cade07a0b2ef,Job 18,130,145,15,2024-06-23T12:17:18.009Z,2024-06-23T12:17:48.002Z,0,5
ad3761db-6333-4467-8766-008aaac98109,c8c0eed3-e439-4f02-845e-773909bf9b4a,Job 19,131,146,15,2024-06-23T12:17:20.009Z,2024-06-23T12:17:50.002Z,0,5
073c59f0-06a6-4ab3-9237-0f53821de845,0be44fc3-dc4c-47b7-9e34-81995dd6340f,Job 20,133,152,19,2024-06-23T12:17:24.030Z,2024-06-23T12:18:02.002Z,0,10
dcd7db79-717a-4599-a09c-df1ab4c1b832,3bd877e2-1f77-4530-9142-18eb385eb34b,Job 01,241,256,15,2024-06-23T12:21:00.012Z,2024-06-23T12:21:30.002Z,0,3
f6daa432-9dbd-4379-bf10-1954091cb2d8,44521271-888c-4fc5-af46-021a89d58795,Job 02,242,257,15,2024-06-23T12:21:02.013Z,2024-06-23T12:21:32.002Z,0,3
fe1d4aa9-d811-42fb-9fa6-3bf789f48eb2,6f7fa26e-3f38-47c0-a016-4d76ff1df6e6,Job 03,243,258,15,2024-06-23T12:21:04.037Z,2024-06-23T12:21:34.003Z,0,3
1b44d91d-f539-4f87-827b-7298a5446478,3c23cb88-d7d0-4c0b-b186-53ef4a36ecea,Job 04,244,259,15,2024-06-23T12:21:06.008Z,2024-06-23T12:21:36.001Z,0,5
b1438c9e-a55d-4b6e-ba9b-8ed6314c9253,7d1b8f5f-9338-40fa-9a1b-ac3c7a47e497,Job 06,246,261,15,2024-06-23T12:21:10.012Z,2024-06-23T12:21:40.003Z,0,5
4d3de169-5d7f-4736-bc28-7d75350ba944,9243b2c7-9421-48bb-8346-c92b31c738f3,Job 07,247,262,15,2024-06-23T12:21:12.012Z,2024-06-23T12:21:42.002Z,0,10
da634e83-ccb4-4952-ae5a-e4bf699de161,3c997e2c-2fe2-4b1a-9855-a972bb764c25,Job 08,253,271,18,2024-06-23T12:21:24.012Z,2024-06-23T12:22:00.003Z,0,10
1c7e5d82-38e7-44d9-9111-60dcf3db5427,d475592f-1aef-411d-9eda-7711d59d5e8b,Job 05,245,275,30,2024-06-23T12:21:08.011Z,2024-06-23T12:22:08.002Z,0,5
38af7bbc-83ba-4d69-b6ab-d1e4ab616049,d3b4667c-23c9-4a84-837a-ad352c991afb,Job 10,261,276,15,2024-06-23T12:21:40.022Z,2024-06-23T12:22:10.003Z,0,3
22117a9e-4620-4d43-8b35-ce3739653b1e,4be0a0af-d0a7-424b-9564-aea9983b15f3,Job 11,262,277,15,2024-06-23T12:21:42.021Z,2024-06-23T12:22:12.001Z,0,5
373c1d7d-f056-4517-b2aa-e0fc9acb4b88,ce01bde3-bbdd-40d0-af2c-3de167b82b75,Job 12,263,278,15,2024-06-23T12:21:44.010Z,2024-06-23T12:22:14.002Z,0,10
64990f57-3624-4250-9d77-e44553c87137,29a1ca68-6e8a-429c-8034-b6393005c968,Job 09,258,288,30,2024-06-23T12:21:34.014Z,2024-06-23T12:22:34.003Z,0,10
6ac1a01d-63f1-424c-8370-67a1861e5ef3,feb297fb-06db-4752-9dd0-80636f8b0d81,Job 14,275,291,16,2024-06-23T12:22:08.020Z,2024-06-23T12:22:40.001Z,0,5
3e9bdbe7-316b-49e7-82d9-64465aec4dd1,44258a72-e0fe-4986-9c41-ffd4055ec02d,Job 15,277,292,15,2024-06-23T12:22:12.012Z,2024-06-23T12:22:42.002Z,0,5
09acd707-e18d-41e2-8393-73a8eb490d40,52f8e1a6-2fe2-4246-a689-c1d038afe396,Job 16,278,294,16,2024-06-23T12:22:14.011Z,2024-06-23T12:22:46.001Z,0,3
ec012c8b-5288-4d95-bf92-ce753fe6aaa0,efec4921-c23d-4a38-89f9-5fd0704f5b9c,Job 17,279,294,15,2024-06-23T12:22:16.006Z,2024-06-23T12:22:46.004Z,0,5
300f3b5f-1bda-4a21-9c7b-58513e10d531,fb7ce298-0ae8-4ffa-aee0-bf04793b51e6,Job 13,271,298,27,2024-06-23T12:22:00.012Z,2024-06-23T12:22:54.002Z,0,5
6fcaea72-db8b-4e01-884c-4600ef174830,1002fe6e-fb26-4f2e-aa86-0ccbdc0934d3,Job 18,286,301,15,2024-06-23T12:22:30.009Z,2024-06-23T12:23:00.002Z,0,5
ad3761db-6333-4467-8766-008aaac98109,6c39f047-31a2-44a1-95c9-bdff558d874e,Job 19,288,303,15,2024-06-23T12:22:34.018Z,2024-06-23T12:23:04.003Z,0,5
073c59f0-06a6-4ab3-9237-0f53821de845,2b6fa6fa-1d44-4bdb-b7fe-11715a1c895c,Job 20,289,306,17,2024-06-23T12:22:36.005Z,2024-06-23T12:23:10.003Z,0,10
