jobId,executionId,jobName,startedTick,finishedTick,ticks,startedAt,finishedAt,startLateBy,resourceUsage
836875e0-db4e-48f3-9455-fce8b5fbb7a2,365f53eb-fdd1-4b7f-bd39-8f3288a5e9ca,Job 01,76,92,16,2024-04-29T07:41:30.056Z,2024-04-29T07:42:02.003Z,0,3
ee36cb88-7356-4286-9a4b-d65f223ebec4,762e7595-5c8e-488f-90bb-e345a03b1866,Job 02,77,92,15,2024-04-29T07:41:32.044Z,2024-04-29T07:42:02.023Z,0,3
b6caff00-67b9-4e69-95bc-eb361ddbf85b,02198e36-f5fa-4cc7-b7d2-22fed122f9e6,Job 03,78,93,15,2024-04-29T07:41:34.023Z,2024-04-29T07:42:04.002Z,0,3
ed8f40e7-e2cb-4902-a893-20bc2eed40b9,c442c32b-8a7d-4072-9a06-f5c31999044e,Job 05,80,96,16,2024-04-29T07:41:38.044Z,2024-04-29T07:42:10.003Z,0,5
104c3fa6-73f7-45d9-aa95-63a32da1b381,085a0c5f-568a-412d-aed8-5dc42fb6689a,Job 06,81,96,15,2024-04-29T07:41:40.029Z,2024-04-29T07:42:10.020Z,0,5
69e2d8c4-43e9-4e42-9de0-53c1d6f0052d,7d6521ab-032e-4d88-8c2f-fd445995fcf0,Job 07,82,99,17,2024-04-29T07:41:42.043Z,2024-04-29T07:42:16.001Z,0,10
dbdcc15e-d256-4149-88a5-401b66bccab3,204f553c-ee06-4980-956b-de8b73f9da38,Job 08,92,107,15,2024-04-29T07:42:02.056Z,2024-04-29T07:42:32.003Z,0,10
a61c4916-d6cf-4262-9a61-ed571d7fb6e9,572f0bb0-dda8-4ad2-a333-9f984f087311,Job 04,79,109,30,2024-04-29T07:41:36.010Z,2024-04-29T07:42:36.001Z,0,5
3420f655-9b3c-4b0a-a9eb-707d25e68ab9,b90c2952-622b-41f5-a15d-6999283bba2f,Job 09,94,109,15,2024-04-29T07:42:06.037Z,2024-04-29T07:42:36.004Z,0,10
a0fc3dab-e252-4c74-9a7e-2d8288ed09a2,c83a33c4-515a-4a14-a10a-f2a4189b6d69,Job 10,96,111,15,2024-04-29T07:42:10.044Z,2024-04-29T07:42:40.003Z,0,3
d7dc9073-4e37-4c3f-a6a7-252bb0a850b8,a2b72484-ad4b-40a0-9328-44a34eca877d,Job 13,101,116,15,2024-04-29T07:42:20.026Z,2024-04-29T07:42:50.003Z,0,5
ae144cda-6383-48d5-b187-c99dfdb3df4c,13981958-095d-4537-adf7-c54c78c293e4,Job 14,102,118,16,2024-04-29T07:42:22.011Z,2024-04-29T07:42:54.002Z,0,5
12c71f3e-9f9f-4ce6-8e6a-c3675d9b50d6,4510e7c4-9a1e-4243-afa3-8984d5603f45,Job 15,103,118,15,2024-04-29T07:42:24.025Z,2024-04-29T07:42:54.015Z,0,5
2711c2d9-bb47-4689-bf42-614366a78f53,08cf9ebb-373b-48dd-887b-a4203bdb74c0,Job 11,97,120,23,2024-04-29T07:42:12.042Z,2024-04-29T07:42:58.002Z,0,5
4eda0923-a105-43af-9992-a55e8ce469a8,b643ce33-2c2e-4e4c-aca4-6c8fc8e9ea9d,Job 18,106,121,15,2024-04-29T07:42:30.022Z,2024-04-29T07:43:00.001Z,0,5
f5af7f3e-a443-45ee-b0e3-75f3aa9068fa,2e234083-9d9b-459f-a1bb-de8af1c4d13a,Job 17,105,124,19,2024-04-29T07:42:28.024Z,2024-04-29T07:43:06.000Z,0,5
848b6056-2916-4fce-adde-f50c62d5335d,e26e8b92-e073-4535-bf6b-59fcce5c1ddc,Job 20,108,124,16,2024-04-29T07:42:34.010Z,2024-04-29T07:43:06.005Z,4,10
0f04bbef-659e-4870-bd0a-8af26fb20f2c,0338670f-30e5-45ac-98c5-bbcd4e2d0fc8,Job 19,107,128,21,2024-04-29T07:42:32.033Z,2024-04-29T07:43:14.002Z,2,5
54ab3b9e-20f1-45de-9aaf-18b4605cb052,b660faa4-6218-47a2-8b81-b13808291bc5,Job 12,100,130,30,2024-04-29T07:42:18.027Z,2024-04-29T07:43:18.003Z,0,10
94d98c66-9c32-4c8b-a994-d2516dab6e7d,8fd4b366-b023-4e36-9c34-86523ebd107d,Job 16,104,134,30,2024-04-29T07:42:26.006Z,2024-04-29T07:43:26.001Z,0,3
