jobId,executionId,jobName,startedTick,finishedTick,ticks,startedAt,finishedAt,startLateBy,resourceUsage
b089522e-c630-4d05-9ed2-128ae79408ca,683a5b17-559f-4ff2-84f7-35442a9254a6,Job 03,19,34,15,2024-04-29T08:10:34.044Z,2024-04-29T08:11:04.002Z,0,3
16bc050c-94dc-4b36-b766-02f7a4943601,44054fb4-26be-42e3-a69c-8f5a3edfb914,Job 04,20,35,15,2024-04-29T08:10:36.050Z,2024-04-29T08:11:06.002Z,0,5
453e8e9b-0181-4753-8589-396e50863978,75754d11-d3fd-4afc-8b8d-35581b8cc674,Job 02,18,36,18,2024-04-29T08:10:32.043Z,2024-04-29T08:11:08.004Z,0,3
558957c8-b0d4-43f6-b45a-2c05160f9bd8,c6fdc267-f33f-401c-8b32-01b8571ee00a,Job 01,17,38,21,2024-04-29T08:10:30.056Z,2024-04-29T08:11:12.005Z,0,3
fad7e5f4-13b9-49f1-b0a9-151172317947,fcc5a76f-f757-42f7-a66f-68c03832e9f5,Job 05,34,49,15,2024-04-29T08:11:05.045Z,2024-04-29T08:11:34.004Z,0,5
dc4f61d4-35ce-4f2b-885c-6036d733cab9,2eae3a48-3266-475c-bb87-c0c86ff03e68,Job 06,36,53,17,2024-04-29T08:11:08.029Z,2024-04-29T08:11:42.004Z,0,5
322b4085-4d9c-4dc3-9270-8338caa661ea,cc85f41b-fe70-4893-a577-554ee1e64c7c,Job 07,38,55,17,2024-04-29T08:11:12.044Z,2024-04-29T08:11:46.003Z,0,10
9977cec4-5856-4b37-b706-3afb99e9d42a,0a193457-dbbe-4448-b590-e0bb8fa53ee9,Job 08,55,70,15,2024-04-29T08:11:46.042Z,2024-04-29T08:12:16.002Z,0,10
91a1954f-86df-4e0d-a28b-5427d8411ed1,47013a4d-72fd-401e-9f2b-613a2a2b48d8,Job 09,70,85,15,2024-04-29T08:12:16.044Z,2024-04-29T08:12:46.001Z,0,10
fa7157f9-31c1-416a-8b8e-a6b8c063e163,52315b0f-54f6-470b-bbca-d80f33c8b82d,Job 10,77,93,16,2024-04-29T08:12:30.037Z,2024-04-29T08:13:02.002Z,0,3
47563046-8fa8-4aa3-8815-03634dc5f85f,b0ced626-c536-4cb9-8336-e7fdffde2956,Job 13,86,101,15,2024-04-29T08:12:48.026Z,2024-04-29T08:13:18.003Z,0,5
58ce53fe-7c0e-4e7c-a491-b5ba9468ce4d,3a2e38cc-e531-428c-9011-095034b3ed75,Job 14,87,102,15,2024-04-29T08:12:50.028Z,2024-04-29T08:13:20.002Z,0,5
6beb1868-df3d-4a9e-97da-c131362a2683,759209df-fbdd-42ad-aa41-861906709872,Job 15,89,104,15,2024-04-29T08:12:54.022Z,2024-04-29T08:13:24.003Z,0,5
9bc4af03-dd51-4f97-9295-dff730cc2522,9fd7a630-f3cf-44ab-990f-b9fc0e0b5fea,Job 16,91,107,16,2024-04-29T08:12:58.012Z,2024-04-29T08:13:30.002Z,0,3
f279620a-e04b-493c-873e-2e33b47e47f2,9e09f936-321f-4399-8445-7b33384cc2cd,Job 17,92,107,15,2024-04-29T08:13:00.025Z,2024-04-29T08:13:30.015Z,0,5
aed7ea05-852a-44a1-9b42-3764f4e9a62b,8b301d3f-395a-4e67-98b0-eb4f62f9c060,Job 11,78,108,30,2024-04-29T08:12:32.016Z,2024-04-29T08:13:32.002Z,0,5
fb80e672-5719-4c0d-bfb5-5ab9198d98e5,c96b8d0b-f951-4aab-b296-a41528695149,Job 18,93,108,15,2024-04-29T08:13:02.031Z,2024-04-29T08:13:32.011Z,0,5
ea3ee78b-966e-45c9-ad8a-6394a7be4922,6a77febb-7512-4a87-b378-86820e0986fb,Job 12,79,109,30,2024-04-29T08:12:34.034Z,2024-04-29T08:13:34.002Z,0,10
8aeb36c8-851e-47bd-bdc7-ff4cb76ee60c,510d649d-099d-4688-ac83-7ce2b5478ddb,Job 19,94,109,15,2024-04-29T08:13:04.012Z,2024-04-29T08:13:34.013Z,0,5
b07976f6-4b98-49fa-819f-01fd8cea430c,fb57d0c8-ca05-4da5-896e-32dee1e15bc2,Job 20,95,110,15,2024-04-29T08:13:06.023Z,2024-04-29T08:13:36.002Z,0,10
