jobId,executionId,jobName,startedTick,finishedTick,ticks,startedAt,finishedAt,startLateBy,resourceUsage
c19b5c57-4d5d-4688-871e-191a4f1b0ede,d0fbffa5-e422-4287-a993-85abb1df8a57,Job 01,55,70,15,2024-04-29T08:06:00.063Z,2024-04-29T08:06:30.004Z,0,3
d9660f4d-aa47-4b66-b01c-d344e022a3ab,5eee88a8-61a5-45d2-b153-d575f7a1fc3f,Job 04,58,74,16,2024-04-29T08:06:06.050Z,2024-04-29T08:06:38.002Z,0,5
9f4fe572-63e9-4942-968d-f88ed656610c,a74a077f-6de3-4439-8809-23230a7fb114,Job 03,57,75,18,2024-04-29T08:06:04.047Z,2024-04-29T08:06:40.001Z,0,3
119b942b-2ff3-449e-bc66-6e0c725d6c90,035006ff-61e6-4e0f-8b29-643f5997409e,Job 05,59,75,16,2024-04-29T08:06:08.022Z,2024-04-29T08:06:40.022Z,0,5
82fdb85a-6545-40e6-b117-61e91c08b341,a92b67c0-3255-4fff-9ef3-ae0d247c4aba,Job 02,56,76,20,2024-04-29T08:06:02.054Z,2024-04-29T08:06:42.002Z,0,3
f4b46a6f-f8fe-4a26-8b75-d0f02483f4ce,13a0b535-f70e-4ae8-81c7-0908cac2abc0,Job 06,74,89,15,2024-04-29T08:06:38.049Z,2024-04-29T08:07:08.003Z,0,5
8bacf7f1-afc1-4300-8e9e-f0318c730130,2d662420-f41e-4dda-9281-1a48a5d2f91d,Job 07,75,90,15,2024-04-29T08:06:40.052Z,2024-04-29T08:07:10.002Z,0,10
7d060e9a-ed34-4224-870d-33e1906b16e4,b128c24a-83b6-4e70-aa28-5a6618e0fe8d,Job 08,85,101,16,2024-04-29T08:07:00.045Z,2024-04-29T08:07:32.004Z,0,10
311ecc5c-1373-48a3-b02f-3ba553460b57,4ce493c9-754f-4eb7-89e3-9b1f5224677c,Job 09,87,102,15,2024-04-29T08:07:04.038Z,2024-04-29T08:07:34.001Z,0,10
28b07e57-f1dd-49f7-bf25-f4cc349d60c2,35313d06-f468-4bab-ba48-5eded1bcb6ef,Job 11,91,107,16,2024-04-29T08:07:12.044Z,2024-04-29T08:07:44.001Z,0,5
766408f8-021b-42f0-ba24-a01c2b2b3004,cc946a63-e872-45f6-b324-a686112fa871,Job 12,95,110,15,2024-04-29T08:07:20.042Z,2024-04-29T08:07:50.002Z,0,10
c96a496a-08b1-4dc8-9582-e79c76130a14,4dbf4938-54ee-47b2-aebe-67b9ac1621f3,Job 10,90,113,23,2024-04-29T08:07:10.046Z,2024-04-29T08:07:56.003Z,0,3
2489b576-c051-4cbf-a2c8-2e1dbf81a51a,0810df9e-6083-4b5d-91d1-a061db47378c,Job 15,103,118,15,2024-04-29T08:07:36.027Z,2024-04-29T08:08:06.003Z,0,5
eb2bb38a-8799-47c7-8a1e-d5961ba219e1,639536aa-be68-463c-9bcf-16ba6374add9,Job 16,104,119,15,2024-04-29T08:07:38.024Z,2024-04-29T08:08:08.002Z,0,3
bf06a9c6-cad4-4000-b3a9-94220811ba0b,f126297f-257b-46fc-a2bb-3c600c9b44c2,Job 17,105,120,15,2024-04-29T08:07:40.022Z,2024-04-29T08:08:10.003Z,0,5
77ca33f4-b00c-4831-aa22-e7b8f15fdd3e,ddea0fe6-1d98-4020-8136-814ccbd58b0e,Job 18,106,121,15,2024-04-29T08:07:42.022Z,2024-04-29T08:08:12.002Z,0,5
ea55cb8c-1c8e-47a7-b9fe-51b5d224ba66,98045793-a511-4662-9c1c-505925f53dd6,Job 14,102,123,21,2024-04-29T08:07:34.009Z,2024-04-29T08:08:16.001Z,0,5
3b768260-e6ab-4b7a-83eb-8df57c45f529,21fdd050-c8c5-4e16-b9e1-860c5c86ee0c,Job 20,108,124,16,2024-04-29T08:07:46.021Z,2024-04-29T08:08:18.004Z,0,10
66acff82-222c-425b-8529-d33047a2ddbf,5162f719-9a85-4cb5-8b52-214797a7eeb4,Job 13,101,125,24,2024-04-29T08:07:32.049Z,2024-04-29T08:08:20.002Z,0,5
78f33448-45ff-4245-9ccf-328ad44b9185,a420bddc-7a12-4117-b201-9cd30f915c81,Job 19,107,133,26,2024-04-29T08:07:44.020Z,2024-04-29T08:08:36.002Z,0,5
