jobId,executionId,jobName,startedTick,finishedTick,ticks,startedAt,finishedAt,startLateBy,resourceUsage
3785bad0-bcfc-425e-8fa3-84d54de25ca1,5a281a8f-76eb-40f7-aa1a-6a2a319aa042,Job 01,15,32,17,2024-05-20T11:11:23.051Z,2024-05-20T11:11:56.002Z,0,3
2cfa1b60-d35c-4dbb-97f5-b286cc63bb3c,b8026f21-14d0-4fa4-ba77-43e586a3c07a,Job 02,16,32,16,2024-05-20T11:11:25.025Z,2024-05-20T11:11:56.006Z,0,3
7a07d2bc-19d5-4423-b8e9-ef1cc5c4eff4,45a46ee6-aa0c-4348-a1cf-0dd0a71dfb61,Job 03,17,33,16,2024-05-20T11:11:27.031Z,2024-05-20T11:11:58.002Z,0,3
c2b4b0f1-8043-4a5d-aa33-46c074b2bd9d,7fc0da7e-1181-43ec-8e08-73aa843c9b34,Job 04,18,33,15,2024-05-20T11:11:29.027Z,2024-05-20T11:11:58.007Z,0,5
833dab78-8a27-4f13-9f21-8190c8026d93,ddcc2d64-6248-45a3-b7c0-97a68fac0414,Job 05,19,34,15,2024-05-20T11:11:31.011Z,2024-05-20T11:12:00.001Z,0,5
18b6e46a-aefe-44c0-ac3b-ce477ddfdab8,b7e39da3-1c67-432f-bac0-69d93f846f2f,Job 07,21,37,16,2024-05-20T11:11:35.007Z,2024-05-20T11:12:06.005Z,0,10
9b827966-f4ab-4f4e-ad3f-cdabc348e35e,2671ff50-7f62-4064-b730-70f4c7393660,Job 06,20,38,18,2024-05-20T11:11:33.035Z,2024-05-20T11:12:08.001Z,0,5
26ae3d12-af85-4a09-8364-cbcfc999b35f,3f2a6b09-f6dc-491e-be63-e1be57711304,Job 08,22,39,17,2024-05-20T11:11:37.008Z,2024-05-20T11:12:10.001Z,0,10
1347ff13-e49f-4ef4-9824-0e30fd4005d9,20eb1720-2170-45ff-8042-6d42dc6a9593,Job 09,23,39,16,2024-05-20T11:11:39.007Z,2024-05-20T11:12:10.005Z,0,10
69c53167-bc57-4df3-88b6-e854544e82be,550142c2-ed1a-4403-90f5-e62fcde50ff4,Job 10,24,39,15,2024-05-20T11:11:41.008Z,2024-05-20T11:12:10.008Z,0,3
8b317cfc-b9b8-4deb-92cd-ce6cd831d4a8,910d7cd8-660d-4a1d-8d52-74a3bc5d49ed,Job 12,26,41,15,2024-05-20T11:11:45.013Z,2024-05-20T11:12:14.002Z,0,10
e7ab794f-be32-46d2-8cf4-3e6116ef70d7,856651ba-b98f-44dc-82cd-392e345e883f,Job 13,27,42,15,2024-05-20T11:11:47.006Z,2024-05-20T11:12:16.002Z,0,5
ff684586-03b5-45ba-8d3d-e26269a22c6a,7a0ecedc-3d0d-4e79-8494-a9baa94a3525,Job 14,28,43,15,2024-05-20T11:11:49.021Z,2024-05-20T11:12:18.002Z,0,5
95a97894-59e8-4cc6-a5a3-5e1ab7f2424e,d08b75eb-8a1c-4692-85fd-102141c214b0,Job 15,29,44,15,2024-05-20T11:11:51.016Z,2024-05-20T11:12:20.001Z,0,5
ed32011e-feca-41be-9bab-9b5e054c261a,3fe6c245-ca53-4cae-8e27-ccd50f9b9e62,Job 11,25,45,20,2024-05-20T11:11:43.021Z,2024-05-20T11:12:22.001Z,0,5
410bd5e7-823d-47aa-8e75-94b3c6b01707,38af8ac7-b570-4bba-9d8b-179e154c66e2,Job 17,31,46,15,2024-05-20T11:11:55.008Z,2024-05-20T11:12:24.002Z,0,5
6b38949c-1a51-44d6-a4e7-61fa680f7e7a,e239e439-f97c-4977-b08b-d97d6ed4ff39,Job 18,32,47,15,2024-05-20T11:11:57.005Z,2024-05-20T11:12:26.002Z,0,5
ff8ec081-111e-4461-bd9c-d47fecfc2f8f,0f3b2ca4-15d1-473d-b8f2-3582460ebbd8,Job 16,30,49,19,2024-05-20T11:11:53.006Z,2024-05-20T11:12:30.000Z,0,3
99cf7462-09d3-4332-b885-73f5091fc1f4,93acd22e-0228-4065-9f6d-33dfeaf5ce44,Job 20,34,52,18,2024-05-20T11:12:01.005Z,2024-05-20T11:12:36.001Z,0,10
10e0b5a3-acc6-49d3-a885-f6d7b2463fbc,9480a48f-124c-407f-b9aa-6ba684f1cc99,Job 19,33,60,27,2024-05-20T11:11:59.005Z,2024-05-20T11:12:52.002Z,0,5
3785bad0-bcfc-425e-8fa3-84d54de25ca1,fd36d338-e980-4b44-a17a-9e08f9c1afdc,Job 01,154,169,15,2024-05-20T11:16:01.018Z,2024-05-20T11:16:30.003Z,0,3
2cfa1b60-d35c-4dbb-97f5-b286cc63bb3c,d73f7396-9038-4278-aed2-6d209692f16e,Job 02,155,172,17,2024-05-20T11:16:03.022Z,2024-05-20T11:16:36.002Z,0,3
c2b4b0f1-8043-4a5d-aa33-46c074b2bd9d,98663766-92d3-49d9-9ae7-e5af70d31e89,Job 04,157,172,15,2024-05-20T11:16:07.019Z,2024-05-20T11:16:36.007Z,0,5
18b6e46a-aefe-44c0-ac3b-ce477ddfdab8,392058b2-778c-4212-aca0-949b934df0f6,Job 07,160,175,15,2024-05-20T11:16:13.022Z,2024-05-20T11:16:42.002Z,0,10
7a07d2bc-19d5-4423-b8e9-ef1cc5c4eff4,58282178-a689-4aee-97c9-ec74e08cd0f1,Job 03,156,176,20,2024-05-20T11:16:05.012Z,2024-05-20T11:16:44.002Z,0,3
9b827966-f4ab-4f4e-ad3f-cdabc348e35e,5c95f7b2-0ffb-4136-b929-689aa1f3ba2e,Job 06,159,177,18,2024-05-20T11:16:11.020Z,2024-05-20T11:16:46.002Z,0,5
26ae3d12-af85-4a09-8364-cbcfc999b35f,cb562bc4-ef4e-418a-a827-f42c11c324b6,Job 08,161,178,17,2024-05-20T11:16:15.019Z,2024-05-20T11:16:48.002Z,0,10
69c53167-bc57-4df3-88b6-e854544e82be,777448fc-af1c-482d-b49a-51bc2098d4a5,Job 10,163,178,15,2024-05-20T11:16:19.010Z,2024-05-20T11:16:48.008Z,0,3
1347ff13-e49f-4ef4-9824-0e30fd4005d9,75fa1131-528e-4d84-ab9f-1d81ea7f1205,Job 09,162,179,17,2024-05-20T11:16:17.010Z,2024-05-20T11:16:50.002Z,0,10
ed32011e-feca-41be-9bab-9b5e054c261a,db8c9ca5-c556-48f1-a3a5-1e951611db02,Job 11,164,179,15,2024-05-20T11:16:21.017Z,2024-05-20T11:16:50.010Z,0,5
8b317cfc-b9b8-4deb-92cd-ce6cd831d4a8,abbbf28e-11bc-4eff-9604-981d70eaaa43,Job 12,165,180,15,2024-05-20T11:16:23.017Z,2024-05-20T11:16:52.002Z,0,10
e7ab794f-be32-46d2-8cf4-3e6116ef70d7,4eb34683-7ab2-4509-9b98-2fba3c2133f1,Job 13,166,182,16,2024-05-20T11:16:25.015Z,2024-05-20T11:16:56.001Z,0,5
95a97894-59e8-4cc6-a5a3-5e1ab7f2424e,0111e52f-a5c0-49cc-9002-da4d02a65712,Job 15,168,184,16,2024-05-20T11:16:29.016Z,2024-05-20T11:17:00.001Z,0,5
ff8ec081-111e-4461-bd9c-d47fecfc2f8f,96ee020f-1f70-4182-9fa8-450eac1197a6,Job 16,169,185,16,2024-05-20T11:16:31.016Z,2024-05-20T11:17:02.002Z,0,3
410bd5e7-823d-47aa-8e75-94b3c6b01707,2983d83a-a44c-4114-8cfd-4755d3647057,Job 17,170,186,16,2024-05-20T11:16:33.015Z,2024-05-20T11:17:04.002Z,0,5
833dab78-8a27-4f13-9f21-8190c8026d93,684503c0-1542-476b-a446-51c9e6777f6b,Job 05,158,188,30,2024-05-20T11:16:09.019Z,2024-05-20T11:17:08.003Z,0,5
6b38949c-1a51-44d6-a4e7-61fa680f7e7a,6d9f2fd3-f11b-438c-a7b1-1b6cca9eb9cd,Job 18,171,188,17,2024-05-20T11:16:35.015Z,2024-05-20T11:17:08.007Z,0,5
10e0b5a3-acc6-49d3-a885-f6d7b2463fbc,203cbf32-b9e1-487f-9bb1-5ebab641a00f,Job 19,172,192,20,2024-05-20T11:16:37.014Z,2024-05-20T11:17:16.003Z,0,5
99cf7462-09d3-4332-b885-73f5091fc1f4,c65a50df-ec70-4ceb-b7ed-fb4391558b38,Job 20,175,192,17,2024-05-20T11:16:43.014Z,2024-05-20T11:17:16.008Z,0,10
ff684586-03b5-45ba-8d3d-e26269a22c6a,b4557a0a-6bac-4a14-9b5f-4b71e4475b77,Job 14,167,197,30,2024-05-20T11:16:27.018Z,2024-05-20T11:17:26.002Z,0,5
