jobId,executionId,jobName,startedTick,finishedTick,ticks,startedAt,finishedAt,startLateBy,resourceUsage
a62dab52-c9b0-448e-b48f-2bf6ba2bba7f,561ea23f-445a-4096-90a6-a4372e52b988,Job 02,7,22,15,2024-04-29T08:55:23.059Z,2024-04-29T08:55:52.003Z,0,3
fb6c87e8-40e2-4da3-8158-ce1a3877cfa4,95d87b06-ce13-4ed2-9af3-47e4e6c3256c,Job 08,10,25,15,2024-04-29T08:55:29.021Z,2024-04-29T08:55:58.002Z,0,10
fd6e2e0b-f487-40fe-9b5a-3ac6235ea55c,a5b00b19-466a-4dc5-ac1a-ef64884b465c,Job 06,9,26,17,2024-04-29T08:55:27.041Z,2024-04-29T08:56:00.002Z,0,5
0e420533-54f3-4993-af8d-0adc6b6c1ff4,a786f944-02cb-425a-b083-7f21cca40df4,Job 01,11,26,15,2024-04-29T08:55:31.034Z,2024-04-29T08:56:00.019Z,0,3
5f69c9c2-8060-4b84-b9f7-c6a89ae8c279,3a4ea3ab-9741-4179-9576-98b6273ea5f1,Job 04,8,27,19,2024-04-29T08:55:25.039Z,2024-04-29T08:56:02.003Z,0,5
93a131e6-5aec-4042-9879-4d1786436d59,2cf7fb23-fcca-41e9-af6d-bb05421fe732,Job 09,25,40,15,2024-04-29T08:55:59.023Z,2024-04-29T08:56:28.002Z,0,10
1082afda-635a-4d5e-8158-07e978cd61f3,236e1bff-2fd6-4e8a-8362-e0db37defa56,Job 03,12,44,32,2024-04-29T08:55:33.038Z,2024-04-29T08:56:36.003Z,0,3
5423d5bf-f02c-4997-bcdd-d129ec34e9e1,4f9d4edd-469f-40d7-8599-45729a9c7032,Job 07,22,52,30,2024-04-29T08:55:53.041Z,2024-04-29T08:56:52.003Z,0,10
f0f45a5c-2023-41ec-a665-82f598da53bb,9c7c14a4-65e2-454e-a06f-8f8c0b388ca9,Job 12,40,55,15,2024-04-29T08:56:29.034Z,2024-04-29T08:56:58.001Z,0,10
b119e057-2495-40ff-8b1d-eeb3a257e678,77b9e95c-9188-4e61-8408-4b462fa2b4aa,Job 11,41,56,15,2024-04-29T08:56:31.041Z,2024-04-29T08:57:00.003Z,0,5
3450a964-eb0b-4fd6-920b-e997a4332d50,15541645-fd6f-4b24-b958-8ae5cc96a63d,Job 05,13,58,45,2024-04-29T08:55:35.035Z,2024-04-29T08:57:04.003Z,0,5
8cf95eba-0e6c-459e-9970-3a6a3c8df042,76d7c21e-f8f3-4e8f-a19f-67caff259aa1,Job 15,53,68,15,2024-04-29T08:56:55.039Z,2024-04-29T08:57:24.003Z,0,5
e79d7f0a-0861-434c-98f0-0fa884086220,10847e7f-d5a1-462e-b9e2-a87bd291f135,Job 13,52,72,20,2024-04-29T08:56:53.035Z,2024-04-29T08:57:32.003Z,0,5
1c321b0b-04c6-4826-aa03-4c5439b9d57d,b26b3b86-9b97-473e-ad1f-009fa64caa67,Job 14,58,74,16,2024-04-29T08:57:05.035Z,2024-04-29T08:57:36.001Z,0,5
71077dc0-1f27-4134-b7b8-626f9eb4aded,1379028f-d0c9-4de0-b0d5-23df5c4e10cc,Job 20,68,83,15,2024-04-29T08:57:25.041Z,2024-04-29T08:57:54.003Z,0,10
2ac9598e-13d2-4a1f-a3c9-cedaf3da4617,b3f896eb-64d8-443d-9214-01775782ca68,Job 17,55,85,30,2024-04-29T08:56:59.038Z,2024-04-29T08:57:58.003Z,0,5
214d7f4c-ba98-449d-81cf-1dba8d4d3b61,5577dcaf-181e-4b32-9203-ec94e175489f,Job 10,26,86,60,2024-04-29T08:56:01.038Z,2024-04-29T08:58:00.002Z,0,3
721424f4-ce16-43b5-a3e0-aabd3b032848,1b34c6bc-644d-49e8-9515-e1c4d47ff17b,Job 16,80,88,8,2024-04-29T08:57:49.023Z,2024-04-29T08:58:04.001Z,0,3
d39abc1a-510e-41a6-83a4-f36a28ac7c18,04e8f9a5-2698-4147-b452-1ae1869f912a,Job 21,85,101,16,2024-04-29T08:57:59.028Z,2024-04-29T08:58:30.002Z,0,5
b361e9d4-613a-490e-b833-6cbde6cceed1,213e525f-fbdb-4ebb-94bc-1e97b6534648,Job 23,86,102,16,2024-04-29T08:58:01.025Z,2024-04-29T08:58:32.002Z,0,5
71f2c338-9875-47a6-b2cd-44c39656fa3d,c9144a21-7749-4655-acd4-045d75eecd3f,Job 25,87,102,15,2024-04-29T08:58:03.017Z,2024-04-29T08:58:32.010Z,0,5
2d5fb149-edbb-41b9-b500-a56c3e2d04e6,0200bc86-a8d2-432c-bf40-fdf203b28b6f,Job 26,108,116,8,2024-04-29T08:58:45.020Z,2024-04-29T08:59:00.003Z,0,3
95c3bfb8-9a2f-406a-a546-ccfda3b02d55,8f3b363b-db32-49f6-a658-6d1462db184d,Job 18,27,117,90,2024-04-29T08:56:03.037Z,2024-04-29T08:59:02.001Z,0,5
348f1a20-958c-4e99-bb15-24b9fca7747d,de750d9f-fe80-4f92-a9b9-e49f4f4bb8df,Job 22,101,117,16,2024-04-29T08:58:31.024Z,2024-04-29T08:59:02.014Z,0,10
938c95e5-87fd-4d52-9308-aabf9c7ec75d,a2abdea4-8183-494e-ad52-fe548d7c0c63,Job 24,102,117,15,2024-04-29T08:58:33.006Z,2024-04-29T08:59:02.027Z,0,5
2c1d38bd-9caa-40bf-a8f2-696eeda1c067,69c06d68-2fe3-457e-8145-fbd7337595a3,Job 30,103,119,16,2024-04-29T08:58:35.020Z,2024-04-29T08:59:06.001Z,0,10
f665e9fd-02b4-4651-9424-a4a8679efe02,974f6210-fa53-4e71-9743-e78c6f57d09f,Job 19,56,120,64,2024-04-29T08:57:01.034Z,2024-04-29T08:59:08.002Z,0,5
4f570c9a-3cec-4aca-84d7-2df47a0d280c,23ce905a-22f9-49bc-a03b-1bdc1d4e3c73,Job 28,83,128,45,2024-04-29T08:57:55.032Z,2024-04-29T08:59:24.002Z,0,5
cebefb55-108e-4b85-b97e-a7501484d5bb,dee04ffe-8996-41f4-b0db-7d62033aa2fb,Job 27,74,134,60,2024-04-29T08:57:37.021Z,2024-04-29T08:59:36.004Z,0,5
30a5654c-3786-452a-9d37-98d7767ce6fd,6c12a186-8d4c-4e9a-bad7-607da9c6f808,Job 29,71,145,74,2024-04-29T08:57:31.044Z,2024-04-29T08:59:58.001Z,0,5
a62dab52-c9b0-448e-b48f-2bf6ba2bba7f,9aec98d3-9ed6-49bd-8bd8-fbf988a324e8,Job 02,146,163,17,2024-04-29T09:00:01.010Z,2024-04-29T09:00:34.002Z,0,3
fd6e2e0b-f487-40fe-9b5a-3ac6235ea55c,23e87ee1-47b1-4757-8e1e-647f96959a75,Job 06,148,163,15,2024-04-29T09:00:05.033Z,2024-04-29T09:00:34.006Z,0,5
5f69c9c2-8060-4b84-b9f7-c6a89ae8c279,9f30c8af-218b-4215-a6d3-e35b2c9f595a,Job 04,147,165,18,2024-04-29T09:00:03.025Z,2024-04-29T09:00:38.002Z,0,5
fb6c87e8-40e2-4da3-8158-ce1a3877cfa4,3cf30f1b-99be-4755-9e0d-0c24e2cb3d11,Job 08,149,165,16,2024-04-29T09:00:07.007Z,2024-04-29T09:00:38.012Z,0,10
0e420533-54f3-4993-af8d-0adc6b6c1ff4,fcf6384a-b812-47d2-81e3-cec58e17ef8b,Job 01,161,176,15,2024-04-29T09:00:31.037Z,2024-04-29T09:01:00.001Z,0,3
1082afda-635a-4d5e-8158-07e978cd61f3,7ae538d2-b281-4bbb-8b93-27670a49e9bc,Job 03,162,187,25,2024-04-29T09:00:33.014Z,2024-04-29T09:01:22.002Z,0,3
93a131e6-5aec-4042-9879-4d1786436d59,70616f7d-68f3-47ce-a734-97813252bedb,Job 09,165,195,30,2024-04-29T09:00:39.011Z,2024-04-29T09:01:38.003Z,0,10
5423d5bf-f02c-4997-bcdd-d129ec34e9e1,f3234492-9abf-400b-89bb-c0c52bdda285,Job 07,164,199,35,2024-04-29T09:00:37.026Z,2024-04-29T09:01:46.003Z,0,10
b119e057-2495-40ff-8b1d-eeb3a257e678,5f776924-ec00-4a2b-979a-28d7485a5add,Job 11,191,207,16,2024-04-29T09:01:31.009Z,2024-04-29T09:02:02.003Z,0,5
e79d7f0a-0861-434c-98f0-0fa884086220,98a7989f-8ac4-45b8-9793-b2157fc2130d,Job 13,192,207,15,2024-04-29T09:01:33.040Z,2024-04-29T09:02:02.013Z,0,5
3450a964-eb0b-4fd6-920b-e997a4332d50,2b4299af-6112-4f6d-97fd-8c46f088deee,Job 05,163,208,45,2024-04-29T09:00:35.034Z,2024-04-29T09:02:04.002Z,0,5
8cf95eba-0e6c-459e-9970-3a6a3c8df042,2285bf2c-b07b-45ac-897c-cd5610cfac63,Job 15,195,210,15,2024-04-29T09:01:39.042Z,2024-04-29T09:02:08.002Z,0,5
214d7f4c-ba98-449d-81cf-1dba8d4d3b61,f871cc6d-37fa-4a0b-9ec8-c5f20cf20aec,Job 10,150,211,61,2024-04-29T09:00:09.014Z,2024-04-29T09:02:10.002Z,0,3
95c3bfb8-9a2f-406a-a546-ccfda3b02d55,d36dcfc8-2406-4d2b-9633-b5cea3fc17de,Job 18,176,221,45,2024-04-29T09:01:01.009Z,2024-04-29T09:02:30.002Z,0,5
f0f45a5c-2023-41ec-a665-82f598da53bb,7a9ce718-2718-4078-a8ed-af813102700d,Job 12,207,222,15,2024-04-29T09:02:03.028Z,2024-04-29T09:02:32.002Z,0,10
1c321b0b-04c6-4826-aa03-4c5439b9d57d,9a9d5d8c-a2d3-412f-bed4-5b5ad1262b77,Job 14,210,225,15,2024-04-29T09:02:09.029Z,2024-04-29T09:02:38.002Z,0,5
2ac9598e-13d2-4a1f-a3c9-cedaf3da4617,da49b8b4-7f8f-45f7-86dd-75028becaf61,Job 17,199,231,32,2024-04-29T09:01:47.039Z,2024-04-29T09:02:50.003Z,0,5
71077dc0-1f27-4134-b7b8-626f9eb4aded,27dc4e8f-2a65-415b-bfdc-bfa458e5cc36,Job 20,221,236,15,2024-04-29T09:02:31.028Z,2024-04-29T09:03:00.001Z,0,10
721424f4-ce16-43b5-a3e0-aabd3b032848,a9462a4d-f493-4942-8daf-d282aa4ff128,Job 16,228,236,8,2024-04-29T09:02:45.024Z,2024-04-29T09:03:00.011Z,0,3
d39abc1a-510e-41a6-83a4-f36a28ac7c18,1cdb026b-231d-4452-8515-bc06d313339b,Job 21,234,251,17,2024-04-29T09:02:57.024Z,2024-04-29T09:03:30.003Z,0,5
71f2c338-9875-47a6-b2cd-44c39656fa3d,bc6aa2a3-5bd6-4ff0-be36-5dc4ba3770bf,Job 25,236,251,15,2024-04-29T09:03:01.021Z,2024-04-29T09:03:30.010Z,0,5
cebefb55-108e-4b85-b97e-a7501484d5bb,3837eef1-ac87-4c26-a85f-0e34f6876381,Job 27,222,252,30,2024-04-29T09:02:33.035Z,2024-04-29T09:03:32.001Z,0,5
4f570c9a-3cec-4aca-84d7-2df47a0d280c,0d7ac68a-e589-406e-9b47-f3d65a8fcc67,Job 28,211,256,45,2024-04-29T09:02:11.028Z,2024-04-29T09:03:40.003Z,0,5
f665e9fd-02b4-4651-9424-a4a8679efe02,3a3468bc-3f91-4287-b7f9-0d2eae77757b,Job 19,200,260,60,2024-04-29T09:01:49.015Z,2024-04-29T09:03:48.001Z,0,5
b361e9d4-613a-490e-b833-6cbde6cceed1,e9baa574-639d-4199-b006-b29f3e062477,Job 23,235,265,30,2024-04-29T09:02:59.022Z,2024-04-29T09:03:58.001Z,0,5
2d5fb149-edbb-41b9-b500-a56c3e2d04e6,3f3971eb-8a07-4c7a-a778-9b33a6d4abb9,Job 26,257,265,8,2024-04-29T09:03:43.015Z,2024-04-29T09:03:58.009Z,0,3
348f1a20-958c-4e99-bb15-24b9fca7747d,fcd4a886-b8d0-4731-b213-9cc2002ae1c7,Job 22,250,266,16,2024-04-29T09:03:29.010Z,2024-04-29T09:04:00.002Z,0,10
2c1d38bd-9caa-40bf-a8f2-696eeda1c067,ddd0799c-e329-408c-816c-edbca5a14144,Job 30,252,267,15,2024-04-29T09:03:33.020Z,2024-04-29T09:04:02.002Z,0,10
938c95e5-87fd-4d52-9308-aabf9c7ec75d,d4ac23fe-cbd2-4d81-91e9-530b4e4b858f,Job 24,251,281,30,2024-04-29T09:03:31.018Z,2024-04-29T09:04:30.002Z,0,5
30a5654c-3786-452a-9d37-98d7767ce6fd,939ebba3-5566-44da-b3a1-f4e7c226ffc3,Job 29,223,283,60,2024-04-29T09:02:35.128Z,2024-04-29T09:04:34.002Z,0,5
