jobId,executionId,jobName,startedTick,finishedTick,ticks,startedAt,finishedAt,startLateBy,resourceUsage
474a37ea-5dba-44ca-bc34-f2a415df9b81,1d5bbed8-0cd6-4ead-a090-90755eed758f,Job 02,6,21,15,2024-04-29T08:15:02.055Z,2024-04-29T08:15:32.003Z,0,3
1d77e6d6-57d6-4791-b67b-dab87e7a347b,3a584fef-f536-451d-80d9-5acbeaca246e,Job 03,7,22,15,2024-04-29T08:15:04.051Z,2024-04-29T08:15:34.003Z,0,3
e989dfc0-167e-47e4-b27c-975ab30206d0,4ff92369-2999-4649-ac65-ad4b1988dce8,Job 01,5,35,30,2024-04-29T08:15:00.036Z,2024-04-29T08:16:00.002Z,0,3
bc742926-1596-4611-a0ed-34a2a9512821,3c82d3ef-32bf-4ccf-b3f9-2d1263cb8db0,Job 05,22,39,17,2024-04-29T08:15:34.044Z,2024-04-29T08:16:08.002Z,0,5
437f5865-a5ab-4298-8d7b-1e3d6c924840,87ea90a2-ac5c-4a50-aa59-a164044cb7c8,Job 04,21,51,30,2024-04-29T08:15:32.048Z,2024-04-29T08:16:32.002Z,0,5
ecb8cae9-b40b-4b60-ad6e-8bd9082aaf19,2da92c8b-f620-4d30-b439-da4267b3ada9,Job 06,39,54,15,2024-04-29T08:16:08.048Z,2024-04-29T08:16:38.004Z,0,5
9ce9dfc6-cf6a-4541-85a5-7418c96c71a1,3dd4a278-e0b5-4cb9-9190-23348ebc8e95,Job 07,51,67,16,2024-04-29T08:16:32.047Z,2024-04-29T08:17:04.002Z,0,10
89f30d08-bebb-4dbf-8ccd-9089b70efb19,43381264-ace4-4f42-8f3e-ca5a56c4c537,Job 08,67,82,15,2024-04-29T08:17:04.017Z,2024-04-29T08:17:34.002Z,0,10
00836a5b-b6a5-4de2-af0c-13edb40077ea,4694fc37-d614-4457-b44d-ee43377dedac,Job 09,82,98,16,2024-04-29T08:17:34.045Z,2024-04-29T08:18:06.002Z,0,10
80b34063-1ce5-455e-b629-a60a800a0630,422ae56b-13a4-4c2f-88d5-2149d659bbae,Job 11,96,111,15,2024-04-29T08:18:02.015Z,2024-04-29T08:18:32.003Z,0,5
75e9ceab-7ea1-4ef1-8738-71d2c0e27c43,73e806da-2b75-4744-9b09-d08bd50bf49c,Job 13,98,113,15,2024-04-29T08:18:06.046Z,2024-04-29T08:18:36.002Z,0,5
edf3a6d4-0cf4-4ba7-bc2d-917db22960f9,c0612b58-f06b-4ac5-a141-6dde2be6ff08,Job 10,95,114,19,2024-04-29T08:18:00.051Z,2024-04-29T08:18:38.003Z,0,3
0532bc76-41bf-461b-9275-4515e53cbc80,485ca717-812c-407a-a480-39574e1f510f,Job 14,103,118,15,2024-04-29T08:18:16.014Z,2024-04-29T08:18:46.003Z,0,5
185b22c2-43ad-441f-8277-bbc26f283c05,658077d1-f192-4f4c-921e-4e526c0efa7e,Job 12,97,119,22,2024-04-29T08:18:04.014Z,2024-04-29T08:18:48.003Z,0,10
95765e37-3088-4ae9-bfac-9b12f40539dc,45f06c5f-3bd2-40b3-a22c-fceba40ba5d3,Job 15,107,122,15,2024-04-29T08:18:24.030Z,2024-04-29T08:18:54.002Z,0,5
fab9b863-ebaf-47b6-b27c-5e7876bd46c8,532bc44c-2708-4d3d-b57c-db3ae2d3f2c1,Job 16,109,124,15,2024-04-29T08:18:28.025Z,2024-04-29T08:18:58.003Z,0,3
8f7399dd-e43c-4a01-ad9f-435f46aeac28,bcdf4169-d4ca-4e71-b547-5dc00b599b56,Job 17,110,125,15,2024-04-29T08:18:30.023Z,2024-04-29T08:19:00.003Z,0,5
383f40d4-2c72-4441-a19e-5a86523b54d6,e1d99dd0-c339-4268-a084-029025ff1915,Job 18,111,128,17,2024-04-29T08:18:32.036Z,2024-04-29T08:19:06.004Z,0,5
4c5d955b-1784-4a83-bbbb-0fdf08d52696,c43575ce-302e-493a-b380-dab727ac5397,Job 19,112,129,17,2024-04-29T08:18:34.009Z,2024-04-29T08:19:08.003Z,0,5
7f5ec3b9-b094-4376-842c-e0a41054fcb6,37082a0d-4cf4-4a30-9935-a527a11dc03b,Job 20,113,129,16,2024-04-29T08:18:36.012Z,2024-04-29T08:19:08.012Z,0,10
