jobId,executionId,jobName,startedTick,finishedTick,ticks,startedAt,finishedAt,startLateBy,resourceUsage
93d05672-b54a-41ef-a865-9e70ae8c302a,6d780163-d45e-49ba-a673-49a16c53ce74,Job 11,15,30,15,2024-04-28T19:53:01.045Z,2024-04-28T19:53:30.002Z,0,15
2c2624fe-699c-42fb-9807-8da17ab8aaa1,522b12f4-4fcc-44dd-b417-2c957ee8efdf,Job 12,25,41,16,2024-04-28T19:53:21.008Z,2024-04-28T19:53:52.003Z,0,15
34abdd0d-d672-423c-9605-4230884c1ed0,dd0a463b-f5a7-42e5-9efc-ee9fa2c9a2d6,Job 13,30,45,15,2024-04-28T19:53:31.008Z,2024-04-28T19:54:00.004Z,0,15
d0d071e5-5a5b-4153-aac8-934e5b44c11c,db7dfbb1-15b4-4b5e-a197-a9d8a5092f01,Job 16,30,45,15,2024-04-28T19:53:31.015Z,2024-04-28T19:54:00.021Z,0,25
37293c00-31ee-40f7-8f03-0204f25e90e7,76477700-1357-46c0-b955-91e8692dd1a6,Job 15,30,46,16,2024-04-28T19:53:31.013Z,2024-04-28T19:54:02.002Z,0,25
f9b140b3-2efc-4f20-96c0-2c1400627d08,1b807cae-08f1-4748-abb8-0d3e8fa84aed,Job 14,30,47,17,2024-04-28T19:53:31.011Z,2024-04-28T19:54:04.003Z,0,15
e866ad59-4890-4e0b-9056-44dfebbed09f,a4c1f0bc-7fa1-4a2b-8e78-f5a37c5708de,Job 17,46,61,15,2024-04-28T19:54:03.032Z,2024-04-28T19:54:32.003Z,0,25
5344c834-2368-4059-99b2-05eeef13f7e0,6a4f8c3c-dff7-495e-81a9-c10c8cdd4f4e,Job 18,46,61,15,2024-04-28T19:54:03.039Z,2024-04-28T19:54:32.015Z,0,15
a7db832e-9fce-4ed2-887e-a809b537431d,6cdf4e24-7d4a-4bdc-9a86-722e91b684eb,Job 19,46,67,21,2024-04-28T19:54:03.044Z,2024-04-28T19:54:44.002Z,0,15
a3a807e2-e167-4b9d-b0ac-02ae4bb55f35,422d5ab0-d02d-4daf-b354-e8b9f1fa2417,Job 20,61,76,15,2024-04-28T19:54:33.016Z,2024-04-28T19:55:02.000Z,3,50
14df0ce0-e122-45c6-a39f-31e167b7f035,c4f9f15f-de0e-4248-9883-93cbb5f72bb7,Job 08,105,120,15,2024-04-28T19:56:01.033Z,2024-04-28T19:56:30.001Z,0,10
03056b26-1970-4b72-9732-d9affda4ddde,08f53ef4-821e-43e7-a11c-72b4ab073a79,Job 05,105,122,17,2024-04-28T19:56:01.028Z,2024-04-28T19:56:34.001Z,0,5
0873bd01-025f-405c-831a-a2062c26f933,50fc1b2a-fa49-4865-90de-3841249a9dcc,Job 03,105,131,26,2024-04-28T19:56:01.022Z,2024-04-28T19:56:52.004Z,0,3
a5e88b19-417d-4f56-9df7-ca2841e36b41,c4f91a64-7404-448d-8938-aee8b969e8ff,Job 04,120,135,15,2024-04-28T19:56:31.024Z,2024-04-28T19:57:00.002Z,0,5
19926c4f-4d98-4c15-95f1-e20db2031e93,27d664a8-80b8-40b1-b2b3-710b048ab950,Job 06,120,135,15,2024-04-28T19:56:31.026Z,2024-04-28T19:57:00.007Z,0,5
d74ff947-af03-4988-a383-84924a6eef78,aadd6d39-3098-41ca-8c70-5f7881deca59,Job 07,120,135,15,2024-04-28T19:56:31.028Z,2024-04-28T19:57:00.009Z,0,10
e5447c0f-69b7-4a43-b238-5db2437f05ea,0a045dc7-237e-4f34-ad0e-b847267bb675,Job 09,120,135,15,2024-04-28T19:56:31.030Z,2024-04-28T19:57:00.011Z,0,10
6cd85ff3-469e-47f8-bb9c-f17d20bfd82e,a8c946be-3fd9-4e30-8e10-748f11678c26,Job 01,120,136,16,2024-04-28T19:56:31.020Z,2024-04-28T19:57:02.001Z,0,3
a1dfd577-29a9-4ce8-9096-772c77aeef4d,58aaf42e-4bce-4b5e-be3c-db5222c2f6e2,Job 02,120,136,16,2024-04-28T19:56:31.022Z,2024-04-28T19:57:02.003Z,0,3
6e36fcae-ff9b-4425-8e1e-ba5b62e61f16,bf6512d3-1e50-46e9-86af-bfefdde6935a,Job 10,120,149,29,2024-04-28T19:56:31.032Z,2024-04-28T19:57:28.001Z,0,20
93d05672-b54a-41ef-a865-9e70ae8c302a,6577cf8b-183f-4d80-9ef3-cd28cd9c9302,Job 11,165,180,15,2024-04-28T19:58:01.021Z,2024-04-28T19:58:30.003Z,0,15
34abdd0d-d672-423c-9605-4230884c1ed0,4dfcbab3-ec7b-4662-8274-83b33c9adf47,Job 13,180,195,15,2024-04-28T19:58:31.013Z,2024-04-28T19:59:00.002Z,0,15
f9b140b3-2efc-4f20-96c0-2c1400627d08,f1bced39-c58f-404a-b946-1c804ef26887,Job 14,180,195,15,2024-04-28T19:58:31.015Z,2024-04-28T19:59:00.011Z,0,15
37293c00-31ee-40f7-8f03-0204f25e90e7,6a4d1b31-e0d5-48f7-9f51-87af432b3d6c,Job 15,180,197,17,2024-04-28T19:58:31.017Z,2024-04-28T19:59:04.002Z,0,25
d0d071e5-5a5b-4153-aac8-934e5b44c11c,0350bc08-1e53-4fc3-a48a-f6b2470d79f2,Job 16,180,198,18,2024-04-28T19:58:31.019Z,2024-04-28T19:59:06.000Z,0,25
2c2624fe-699c-42fb-9807-8da17ab8aaa1,de613de9-6c6c-421d-9d60-749cc5f7466d,Job 12,175,200,25,2024-04-28T19:58:21.023Z,2024-04-28T19:59:10.003Z,0,15
5344c834-2368-4059-99b2-05eeef13f7e0,d88702f3-70ae-4e94-9dd2-fe35fb51da82,Job 18,198,213,15,2024-04-28T19:59:07.029Z,2024-04-28T19:59:36.003Z,0,15
a7db832e-9fce-4ed2-887e-a809b537431d,81c1451d-abae-4f59-9e8b-8af03a99d313,Job 19,198,213,15,2024-04-28T19:59:07.035Z,2024-04-28T19:59:36.008Z,0,15
e866ad59-4890-4e0b-9056-44dfebbed09f,f5aa583c-b6d8-4242-a72e-52c281e17184,Job 17,198,222,24,2024-04-28T19:59:07.021Z,2024-04-28T19:59:54.001Z,0,25
a3a807e2-e167-4b9d-b0ac-02ae4bb55f35,bbaae7cd-d041-478c-9fac-63750c8f29a9,Job 20,213,229,16,2024-04-28T19:59:37.015Z,2024-04-28T20:00:08.002Z,7,50
0873bd01-025f-405c-831a-a2062c26f933,416038a6-392a-4df7-9c58-0e0b0bbb255d,Job 03,255,270,15,2024-04-28T20:01:01.012Z,2024-04-28T20:01:30.002Z,0,3
03056b26-1970-4b72-9732-d9affda4ddde,966d9810-a992-4295-bb22-ed8440e181da,Job 05,255,270,15,2024-04-28T20:01:01.014Z,2024-04-28T20:01:30.006Z,0,5
14df0ce0-e122-45c6-a39f-31e167b7f035,85b8ab0a-9b74-48b5-8032-e87c997b5ddd,Job 08,255,270,15,2024-04-28T20:01:01.015Z,2024-04-28T20:01:30.008Z,0,10
19926c4f-4d98-4c15-95f1-e20db2031e93,e2d70e5b-1ecf-4310-9aad-a1dbcf0305a7,Job 06,270,285,15,2024-04-28T20:01:31.012Z,2024-04-28T20:02:00.001Z,0,5
6e36fcae-ff9b-4425-8e1e-ba5b62e61f16,a8747122-b566-42e2-b7ed-87afad48ec05,Job 10,270,285,15,2024-04-28T20:01:31.017Z,2024-04-28T20:02:00.006Z,0,20
6cd85ff3-469e-47f8-bb9c-f17d20bfd82e,216d565c-43cc-44ea-99a2-b46936a38b02,Job 01,270,287,17,2024-04-28T20:01:31.007Z,2024-04-28T20:02:04.002Z,0,3
a5e88b19-417d-4f56-9df7-ca2841e36b41,b1e25c45-3fec-4de4-ad96-7865f52cb1be,Job 04,270,287,17,2024-04-28T20:01:31.010Z,2024-04-28T20:02:04.009Z,0,5
d74ff947-af03-4988-a383-84924a6eef78,d468132d-655e-45ce-9771-c1c4f15e7e63,Job 07,270,291,21,2024-04-28T20:01:31.014Z,2024-04-28T20:02:12.002Z,0,10
a1dfd577-29a9-4ce8-9096-772c77aeef4d,cd15152e-900c-4580-af8e-a9b7eb3b5edb,Job 02,270,297,27,2024-04-28T20:01:31.009Z,2024-04-28T20:02:24.001Z,0,3
e5447c0f-69b7-4a43-b238-5db2437f05ea,dfa5c8b9-a486-4bc8-a6c6-09d13932f691,Job 09,270,300,30,2024-04-28T20:01:31.015Z,2024-04-28T20:02:30.001Z,0,10
